0 - a wall, 1 - tile with food, 2 - tile with super food, 3 - empty tile, 4 - line
0000000000000000000000000000
0111111111111001111111111110
0100001000001001000001000010
0200001000001001000001000020
0100001000001001000001000010
0111111111111111111111111110
0100001001000000001001000010
0100001001000000001001000010
0111111001111001111001111110
0000001000003003000001000000
3333301000003003000001033333
3333301003333333333001033333
3333301003040000403001033333
0000001003030000303001000000
3333331333033333303331333333
0000001003000000003001000000
3333301003000000003001033333
3333301003333333333001033333
3333301003000000003001033333
0000001003000000003001000000
0111111111111001111111111110
0100001000001001000001000010
0100001000001001000001000010
0211001111111331111111001120
0001001001000000001001001000
0001001001000000001001001000
0111111001111001111001111110
0100000000001001000000000010
0100000000001001000000000010
0111111111111111111111111110
0000000000000000000000000000
